#############
# #   #  #  #
# # #   ##  #
#   # #    ##
#############
